66,67,68,69,70,71,66,67,68,69,70,71,66,67,68,69,70,71,66,67,68,69,70,71,66,67,68,69,70,71,66,67,68,69,70,71,66,67,68,69,70,71,66,67,68,69,70,71,66,67,68,69,70,71,66,67,68,69,70,71,66,67,68,69,70,71,66,67,68,69,70,71,66,67,226,227,228,229,230,231,232,233,70,71,66,67,68,69,70,71,66,67,68,69,70,71,66,67,68,69
98,99,100,101,102,103,98,99,100,101,102,103,98,99,100,101,102,103,98,99,100,101,102,103,98,99,100,101,102,103,98,99,100,101,102,103,98,99,100,101,102,103,98,99,100,101,102,103,98,99,100,101,102,103,98,99,100,101,102,103,98,99,100,101,102,103,98,99,100,101,102,103,98,99,258,259,260,261,262,263,264,265,102,103,98,99,100,101,102,103,98,99,100,101,102,103,98,99,100,101
130,131,132,133,134,135,130,131,132,133,134,135,130,131,132,133,134,135,130,131,132,133,134,135,130,131,132,133,134,135,130,131,132,133,134,135,130,131,132,133,134,135,130,131,132,133,134,135,130,131,132,133,134,135,130,131,132,133,134,135,130,131,132,133,134,135,130,131,132,133,134,135,130,131,290,291,292,293,294,295,296,297,134,135,130,131,132,133,134,135,130,131,132,133,134,135,130,131,132,133
162,163,164,165,166,167,162,163,164,165,166,167,162,163,164,165,166,167,162,163,164,165,166,167,162,163,164,165,166,167,162,163,164,165,166,167,162,163,164,165,166,167,226,227,228,229,230,231,232,233,164,165,166,167,162,163,164,165,166,167,162,163,164,165,166,167,162,163,164,165,166,167,162,163,322,323,324,325,326,327,328,329,166,167,162,163,164,165,166,167,162,163,164,165,166,167,162,163,164,165
194,195,196,197,198,199,194,195,196,197,198,199,194,195,196,197,198,199,226,227,228,229,230,231,232,233,196,197,198,199,194,195,196,197,198,199,194,195,196,197,198,199,258,259,260,261,262,263,264,265,196,197,198,199,194,195,226,227,228,229,230,231,232,233,198,199,194,195,196,197,198,199,194,195,354,355,356,357,358,359,360,361,198,199,194,195,196,226,227,228,229,230,231,232,233,199,194,195,196,197
66,67,226,227,228,229,230,231,232,233,70,71,66,67,68,69,70,71,258,259,260,261,262,263,264,265,68,69,70,71,66,67,68,69,70,226,227,228,229,230,231,232,290,291,292,293,294,295,296,297,68,69,70,71,66,67,258,259,260,261,262,263,264,265,70,71,66,67,68,69,70,71,66,67,386,387,388,389,390,391,392,393,70,71,66,67,68,258,259,260,261,262,263,264,265,71,66,67,68,69
98,99,258,259,260,261,262,263,264,265,102,103,98,99,100,101,102,103,290,291,292,293,294,295,296,297,100,101,102,103,98,99,100,101,102,258,259,260,261,262,263,264,322,323,324,325,326,327,328,329,100,101,102,103,98,99,290,291,292,293,294,295,296,297,102,103,98,99,100,101,102,103,98,99,100,101,102,103,98,99,100,101,102,103,98,99,100,290,291,292,293,294,295,296,297,103,98,99,100,101
130,131,290,291,292,293,294,295,296,297,134,135,130,131,132,133,134,135,322,323,324,325,326,327,328,329,132,133,134,135,130,131,132,133,134,290,291,292,293,294,295,296,354,355,356,357,358,359,360,361,132,133,134,135,130,131,322,323,324,325,326,327,328,329,134,135,130,780,781,782,783,784,785,786,132,133,134,135,130,131,132,133,134,135,130,131,132,322,323,324,325,326,327,328,329,135,130,131,132,133
162,163,322,323,324,325,326,327,328,329,166,167,162,163,164,165,166,167,354,355,356,357,358,359,360,361,164,165,166,167,162,163,164,165,166,322,323,324,325,326,327,328,386,387,388,389,390,391,392,393,164,165,166,167,162,163,354,355,356,357,358,359,360,361,166,167,162,812,813,814,815,816,817,818,164,165,166,167,162,163,164,165,226,227,228,229,230,231,232,233,357,358,359,360,361,167,162,163,164,165
194,195,354,355,356,357,358,359,360,361,198,199,194,195,196,197,198,199,386,387,388,389,390,391,392,393,196,197,198,199,194,195,196,197,198,354,355,356,357,358,359,360,361,195,196,197,198,199,194,195,196,197,198,199,194,195,386,387,388,389,390,391,392,393,198,226,227,844,845,846,847,848,849,850,196,197,198,199,194,195,196,197,258,259,260,261,262,263,264,265,389,390,391,392,393,199,194,195,196,197
66,67,386,387,388,389,390,391,392,393,70,71,66,67,68,69,70,71,66,67,68,69,70,71,66,67,68,69,70,71,66,67,68,69,70,386,387,388,389,390,391,392,393,67,68,69,70,71,66,67,68,69,70,71,66,67,68,69,70,71,66,67,68,69,70,258,259,876,877,878,879,880,881,882,227,228,229,230,231,232,233,69,290,291,292,293,294,295,296,297,66,67,226,227,228,229,230,231,232,233
98,99,100,101,102,103,226,227,228,229,230,231,232,233,100,101,102,103,98,99,100,101,102,103,98,99,100,101,102,103,98,99,100,101,102,103,98,99,100,101,102,103,98,99,100,101,102,103,98,99,100,101,102,103,98,99,100,101,102,103,98,99,100,780,781,782,783,784,785,786,295,296,297,258,259,260,261,262,263,264,265,101,322,323,324,325,326,327,328,329,98,99,258,259,260,261,262,263,264,265
130,131,132,133,134,135,258,259,260,261,262,263,264,265,132,133,134,135,130,131,132,133,134,135,130,131,132,133,134,135,130,131,132,786,787,788,789,790,791,133,134,135,130,131,132,133,134,135,130,131,132,133,134,135,130,131,226,227,228,229,230,231,232,812,813,814,815,816,817,818,327,328,329,290,291,292,293,294,295,296,297,133,354,355,356,357,358,359,360,361,130,131,290,291,292,293,294,295,296,297
162,163,164,165,166,167,290,291,292,293,294,295,296,297,164,165,166,167,162,163,164,165,166,167,162,163,164,165,166,167,162,163,164,818,819,820,821,822,823,165,166,167,162,163,164,165,166,167,162,163,164,165,166,167,162,163,258,259,260,261,262,263,264,844,845,846,847,848,849,850,359,360,361,322,323,324,325,326,327,328,329,165,386,387,388,389,390,391,392,393,162,163,322,323,324,325,326,327,328,329
194,195,196,197,198,199,322,323,324,325,326,327,328,329,196,197,198,199,194,195,196,197,198,199,194,195,196,197,198,199,194,195,226,850,851,852,853,854,855,233,198,199,194,195,196,197,198,199,194,195,196,197,198,199,194,195,290,291,292,293,294,295,296,876,877,878,879,880,881,882,391,392,393,354,355,356,357,358,359,360,361,197,198,199,194,195,196,197,198,199,194,195,354,355,356,357,358,359,360,361
66,67,68,69,70,71,354,355,356,357,358,359,360,361,68,69,70,71,66,67,68,69,70,71,66,67,68,69,70,71,66,67,258,882,883,884,885,886,887,265,70,71,66,67,68,69,70,71,241,242,243,244,245,246,247,248,249,250,251,241,242,243,244,245,246,247,248,249,250,251,70,71,66,386,387,388,389,390,391,226,227,228,229,230,231,232,233,69,70,71,66,67,386,387,388,389,390,391,392,393
98,99,100,101,102,103,386,387,388,389,390,391,392,393,227,228,229,230,231,232,226,227,228,229,230,231,232,233,102,103,98,99,290,914,915,916,917,918,919,297,102,103,98,99,100,101,102,226,273,274,275,276,277,278,279,280,281,282,283,273,274,275,276,277,278,279,280,281,282,283,227,228,229,230,231,232,233,103,98,258,259,260,261,262,263,264,265,101,102,103,98,99,100,101,102,103,98,99,100,101
130,131,132,133,134,135,130,131,132,133,134,135,130,258,259,260,261,262,263,264,258,259,260,261,262,263,264,265,134,135,130,131,322,946,947,948,949,950,951,329,134,135,130,131,132,133,134,258,305,306,307,308,309,310,311,312,313,314,315,305,306,307,308,309,310,311,312,313,314,315,259,260,261,262,263,264,265,135,130,290,291,292,293,294,295,296,297,133,134,135,130,131,132,133,134,135,130,131,132,133
162,163,164,165,166,167,162,163,164,165,166,167,162,290,291,292,293,294,295,296,290,291,292,293,294,295,296,297,166,167,162,163,780,781,782,783,784,785,786,226,227,228,229,230,231,232,233,290,291,292,293,294,295,296,776,777,778,779,780,241,242,243,244,245,246,247,248,249,250,251,291,292,293,294,295,296,297,167,162,322,323,324,325,326,327,328,329,165,166,167,162,163,164,165,166,167,162,163,164,165
194,195,196,197,198,199,194,195,196,197,198,199,194,322,323,324,325,326,327,328,322,323,324,325,326,327,328,329,198,199,194,195,812,813,814,815,816,817,818,258,259,260,261,262,263,264,265,322,323,324,325,326,327,328,808,809,810,811,812,273,274,275,276,277,278,279,280,281,282,283,323,324,325,326,327,328,329,199,194,354,355,356,357,358,359,360,361,229,230,231,232,233,196,197,198,199,194,195,196,197
66,67,68,69,70,71,66,67,68,69,70,71,66,354,355,356,357,358,359,360,354,355,356,357,358,359,360,361,70,71,66,67,844,845,846,847,848,849,850,290,291,292,293,294,295,296,297,354,355,356,357,358,359,360,840,841,842,843,844,305,306,307,308,309,310,311,312,313,314,315,355,356,357,358,359,360,361,71,66,386,387,388,389,390,391,392,393,228,229,230,231,232,233,69,70,71,66,67,68,69
98,99,100,101,102,103,98,99,100,101,102,103,98,386,387,388,389,390,391,392,386,387,388,389,390,391,392,393,102,103,98,99,876,877,878,879,880,881,882,322,323,324,325,326,327,328,329,386,387,388,389,390,391,392,872,873,874,875,876,241,242,243,244,245,246,247,248,249,250,251,387,388,389,390,391,392,393,103,98,99,100,101,102,103,290,258,259,260,261,262,263,264,265,101,102,103,98,99,100,101
130,131,132,133,226,227,228,229,230,231,232,233,130,131,132,133,134,135,130,131,132,133,134,135,130,131,132,780,781,782,783,784,785,786,787,788,789,790,791,354,355,356,357,358,359,360,361,135,130,131,132,133,134,135,904,905,906,907,908,273,274,275,276,277,278,279,280,281,282,283,134,135,130,131,132,133,134,135,130,131,132,133,134,135,322,290,291,292,293,294,295,296,297,133,134,135,130,131,132,133
162,163,164,165,258,259,260,261,262,263,264,265,162,163,164,165,166,167,162,163,164,165,166,167,162,163,164,812,813,814,815,816,817,818,819,820,821,822,823,386,387,388,389,390,391,392,393,167,162,163,164,165,166,167,936,937,938,939,940,305,306,307,308,309,310,311,312,313,314,315,166,167,162,163,164,165,166,167,162,163,164,165,166,167,354,322,323,324,325,326,327,328,329,165,166,167,162,163,164,165
194,195,196,197,290,291,292,293,294,295,296,297,194,195,196,197,198,199,194,195,196,197,198,199,194,195,196,844,845,846,847,848,849,850,851,852,853,854,855,197,198,199,226,227,228,229,230,231,232,233,196,197,198,199,776,777,778,779,780,258,259,260,261,262,263,264,265,195,196,197,198,199,194,195,196,197,198,199,194,195,196,197,198,199,386,354,355,356,357,358,359,360,361,197,198,199,194,195,196,197
66,67,68,69,322,323,324,325,326,327,328,226,227,228,229,230,231,232,233,67,68,69,70,71,66,67,68,876,877,878,879,880,881,882,883,884,885,886,887,69,70,71,258,259,260,261,262,263,264,265,68,69,70,226,808,809,810,811,812,232,233,292,293,294,295,296,297,67,68,69,70,71,66,67,68,69,226,227,228,229,230,231,232,233,66,386,387,388,389,390,391,392,393,69,70,71,66,67,68,69
98,99,100,101,354,355,356,357,358,359,360,258,259,260,261,262,263,264,265,99,100,101,102,103,98,99,100,908,909,910,911,912,913,914,915,916,917,918,919,101,102,103,290,291,292,293,294,295,296,297,100,101,102,258,840,841,842,843,844,264,265,324,325,326,327,328,329,99,100,101,102,103,98,99,100,101,258,259,260,261,262,263,264,265,98,99,100,101,102,103,98,99,100,226,227,228,229,230,231,232
130,131,132,133,386,387,388,389,390,391,392,290,291,292,293,294,295,296,297,131,132,133,134,135,130,131,132,940,941,942,943,944,945,946,947,948,949,950,951,133,134,135,322,323,324,325,326,327,328,329,132,133,134,290,872,873,874,875,876,296,297,356,357,358,359,360,361,131,132,133,134,135,130,131,132,133,290,291,292,293,294,295,296,297,130,131,132,133,134,135,130,131,132,258,259,260,261,262,263,264
241,242,243,244,245,246,247,248,249,250,251,252,253,241,242,243,244,245,246,247,248,249,250,251,252,253,241,242,243,244,245,246,247,248,249,250,251,252,253,165,166,167,354,355,356,357,358,359,360,361,164,165,166,322,904,905,906,907,908,328,329,388,389,390,391,392,393,163,164,165,166,167,162,163,164,165,322,323,780,781,782,783,784,785,786,163,164,165,166,167,162,163,164,290,291,292,293,294,295,296
273,274,275,276,277,278,279,280,281,282,283,284,285,273,274,275,276,277,278,279,280,281,282,283,284,285,273,274,275,276,277,278,279,280,281,282,283,284,285,197,198,199,386,387,388,389,390,391,392,393,196,197,198,354,936,937,938,939,940,360,361,195,196,197,198,199,194,195,226,227,228,229,230,231,232,233,354,355,812,813,814,815,816,817,818,195,196,197,198,199,194,195,196,322,323,324,325,326,327,328
66,67,68,69,70,71,66,67,68,69,70,386,387,388,389,390,391,392,393,258,259,260,261,262,263,264,265,69,258,259,260,261,262,263,264,265,66,148,149,69,70,71,66,67,68,69,70,71,786,787,788,789,790,791,776,777,778,779,780,392,393,67,68,69,70,71,66,67,258,259,260,261,262,263,264,265,386,387,844,845,846,847,848,849,850,67,68,69,70,71,66,67,68,354,355,356,357,358,359,360
98,99,100,101,226,227,228,229,230,231,232,233,98,99,100,101,102,103,98,290,291,292,293,294,295,296,297,101,290,291,292,293,294,295,296,297,98,180,181,101,102,103,98,99,100,101,102,103,818,819,820,821,822,823,808,809,810,811,812,103,98,99,100,101,102,103,98,99,290,291,292,293,294,295,296,297,102,103,876,877,878,879,880,881,882,99,100,101,102,103,98,99,100,386,387,388,389,390,391,392
130,131,132,133,258,259,260,261,226,227,228,229,230,231,232,233,134,135,130,322,323,324,325,326,327,328,329,133,322,323,324,325,326,327,328,329,226,212,213,229,230,231,232,233,132,133,134,135,850,851,852,853,854,855,840,841,842,843,844,81,82,83,84,85,86,87,88,89,90,91,92,93,81,82,83,84,85,86,87,88,89,90,91,92,93,131,132,133,134,135,130,131,132,133,134,135,130,131,132,133
162,163,164,165,290,291,292,293,258,259,260,261,262,263,264,265,166,167,162,354,355,356,357,358,359,360,361,165,354,355,356,357,358,359,360,361,258,244,245,261,262,263,264,265,164,165,166,167,882,883,884,885,886,887,872,873,874,875,876,113,114,115,116,117,118,119,120,121,122,123,124,125,113,114,115,116,117,118,119,120,121,122,123,124,125,163,164,165,166,167,162,163,164,165,166,167,162,163,164,165
194,195,196,197,780,781,782,783,784,785,786,780,781,782,783,784,785,786,194,386,226,227,228,229,230,231,232,233,386,387,388,389,390,391,392,393,290,276,277,293,294,295,296,297,196,197,198,199,914,915,916,917,918,919,904,905,906,907,908,145,146,147,148,149,150,151,152,153,154,155,156,157,145,146,147,148,149,150,151,152,153,154,155,156,157,195,196,197,198,199,194,195,196,197,198,199,194,195,196,197
66,67,68,69,812,813,814,815,816,817,818,812,813,814,815,816,817,818,66,67,258,259,260,261,262,263,264,265,70,71,66,67,68,69,70,71,322,308,309,325,326,327,328,329,226,227,228,229,946,947,948,949,950,951,936,937,938,939,940,177,178,179,180,181,182,183,184,185,186,187,188,189,177,178,179,180,181,182,183,184,185,186,187,188,189,229,230,231,232,233,66,67,68,69,70,71,66,67,68,69
98,99,100,101,844,845,846,847,848,849,850,844,845,846,847,848,849,850,98,99,290,291,292,293,294,295,296,297,102,103,98,99,100,101,102,103,354,340,341,357,358,359,360,361,258,259,260,261,786,787,788,789,790,791,776,777,778,779,780,209,210,211,212,213,214,215,216,217,218,219,220,221,209,210,211,212,213,214,215,216,217,218,219,220,221,261,262,263,264,265,98,99,100,101,102,103,98,99,100,101
130,131,132,133,876,877,878,879,880,881,882,876,877,878,879,880,881,882,130,131,322,323,324,325,326,327,328,329,134,135,130,131,132,133,134,135,386,372,373,389,390,391,392,393,290,291,292,293,818,819,820,821,822,823,808,809,810,811,812,241,242,243,244,245,246,247,248,249,250,251,252,253,241,242,243,244,245,246,247,248,249,250,251,252,253,293,294,295,296,297,226,227,228,229,230,231,232,233,132,133
780,781,782,783,784,785,786,163,164,165,166,167,162,163,164,165,166,167,162,163,354,355,356,357,358,359,360,361,166,167,162,163,164,165,166,167,162,404,405,165,166,167,162,163,322,323,324,325,850,851,852,853,854,855,840,841,842,843,844,273,274,275,276,277,278,279,280,281,282,283,284,285,273,274,275,276,277,278,279,280,281,282,283,284,285,325,326,327,328,329,258,259,260,261,262,263,264,265,164,165
812,813,814,815,816,817,818,195,196,197,198,226,227,228,229,230,231,232,233,195,386,387,388,389,390,391,392,393,198,199,194,195,196,197,198,199,194,195,196,197,198,199,194,195,354,355,356,357,882,883,884,885,886,887,872,873,874,875,876,305,306,307,308,309,310,311,312,313,314,315,316,317,305,306,307,308,309,310,311,312,313,314,315,316,317,357,358,359,360,361,290,291,292,293,294,295,296,297,196,197
844,845,846,847,848,849,850,67,68,69,70,258,259,260,261,262,263,264,265,67,68,69,70,71,66,67,68,69,70,71,66,67,68,69,70,71,226,227,228,229,230,231,232,233,386,387,388,389,914,915,916,917,918,919,904,905,906,907,908,337,338,339,340,341,342,343,344,345,346,347,348,349,337,338,339,340,341,342,343,344,345,346,347,348,349,389,390,391,392,393,322,323,324,325,326,327,328,329,68,69
876,877,878,879,880,881,882,99,100,101,102,290,291,292,293,294,295,296,297,99,100,101,102,103,98,99,100,101,102,103,98,99,100,101,102,103,258,259,260,261,262,263,264,265,100,101,102,103,946,947,948,949,950,951,936,937,938,939,940,369,370,371,372,373,374,375,376,377,378,379,380,381,369,370,371,372,373,374,375,376,377,378,379,380,381,99,100,101,102,103,354,355,356,357,358,359,360,361,100,101
776,777,778,779,780,781,782,783,784,785,786,787,788,789,790,791,776,777,778,779,780,781,782,783,784,785,786,787,788,789,790,791,132,133,134,135,290,291,292,293,294,295,296,297,132,776,777,778,779,780,781,782,783,784,785,786,787,788,789,790,791,776,777,778,779,780,781,782,783,784,785,786,787,788,789,790,791,135,130,131,132,133,134,135,130,131,132,133,134,135,386,387,388,389,390,391,392,393,132,133
808,809,810,811,812,813,814,815,816,817,818,819,820,821,822,823,808,809,810,811,812,813,814,815,816,817,818,819,820,821,822,823,231,232,233,167,322,323,324,325,326,327,328,329,164,808,809,810,811,812,813,814,815,816,817,818,819,820,821,822,823,808,809,810,811,812,813,814,815,816,817,818,819,820,821,822,823,167,162,163,164,165,166,167,162,163,164,165,166,167,162,163,164,165,166,167,162,163,164,165
840,841,842,843,844,845,846,847,848,849,850,851,852,853,854,855,840,841,842,843,844,845,846,847,848,849,850,851,852,853,854,855,263,264,265,199,354,355,356,357,358,359,360,361,226,840,841,842,843,844,845,846,847,848,849,850,851,852,853,854,855,840,841,842,843,844,845,846,847,848,849,850,851,852,853,854,855,199,194,195,196,197,198,199,194,195,196,197,198,199,194,195,196,197,198,199,194,195,196,197
872,873,874,875,876,877,878,879,880,881,882,883,884,885,886,887,872,873,874,875,876,877,878,879,880,881,882,883,884,885,886,887,295,296,297,71,386,387,388,389,390,391,226,226,258,872,873,874,875,876,877,878,879,880,881,882,883,884,885,886,887,872,873,874,875,876,877,878,879,880,881,882,883,884,885,886,887,71,66,226,227,228,229,230,231,232,233,69,70,71,66,67,68,69,70,71,66,67,68,69
904,905,906,907,908,909,910,911,912,913,914,915,916,917,918,919,904,905,906,907,908,909,910,911,912,913,914,915,916,917,918,919,327,328,329,103,98,99,100,101,102,103,258,258,290,904,905,906,907,908,909,910,911,912,913,914,915,916,917,918,919,904,905,906,907,908,909,910,911,912,913,914,915,916,917,918,919,103,98,258,259,260,261,262,263,264,265,101,102,103,98,99,100,101,102,103,98,99,100,101
936,937,938,939,940,941,942,943,944,945,946,947,948,949,950,951,936,937,938,939,940,941,942,943,944,945,946,947,948,949,950,951,359,360,361,135,130,131,132,133,134,135,290,290,322,936,937,938,939,940,941,942,943,944,945,946,947,948,949,950,951,936,937,938,939,940,941,942,943,944,945,946,947,948,949,950,951,135,130,290,291,292,293,294,295,296,297,133,134,135,130,131,132,133,134,135,130,131,132,133
162,163,164,165,166,167,162,163,164,165,166,167,162,163,164,165,386,387,388,389,390,391,392,393,162,163,164,386,387,388,389,390,391,392,393,167,162,163,164,165,166,167,322,322,354,355,356,357,358,359,360,361,166,167,162,163,164,165,166,167,162,163,164,165,166,167,162,163,164,165,166,167,162,163,164,165,166,167,162,322,323,324,325,326,327,328,329,165,166,167,162,163,164,165,166,167,162,163,164,165
194,195,196,197,198,199,194,195,196,197,198,199,194,195,196,197,198,199,194,195,196,197,198,199,194,195,196,197,198,199,194,195,196,197,198,199,194,195,196,197,198,199,354,354,386,387,388,389,390,391,392,393,198,199,194,195,196,197,198,199,194,195,196,197,198,199,194,195,196,197,198,199,194,195,196,197,198,199,194,354,355,356,357,358,359,360,361,197,198,199,194,195,196,197,198,199,194,195,196,197
