66,67,68,69,70,71,72,73,74,75,76,77,78,66,67,68,69,70,71,72,73,74,75,76,77,78,66,67,68,69,70,71,72,73,74,75,76,77,78,66,67,68,69,70,71,72,73,74,75,76,77,78,66,67,68,69,70,71,72,73,74,75,76,77,78,66,67,68,69,70,71,72,73,74,75,76,77,78,66,67,68,69,70,71,72,73,74,75,76,77,78,66,67,68,69,70,71,72,73,74
98,99,100,101,102,103,104,105,106,107,108,109,110,98,99,100,101,102,103,104,105,106,107,108,109,110,98,99,100,101,102,103,104,105,106,107,108,109,110,98,99,100,101,102,103,104,105,106,107,108,109,110,98,99,100,101,102,103,104,105,106,107,108,109,110,98,99,100,101,102,103,104,105,106,107,108,109,110,98,99,100,101,102,103,104,105,106,107,108,109,110,98,99,100,101,102,103,104,105,106
130,131,132,133,134,135,136,137,138,139,140,141,142,130,131,132,133,134,135,136,137,138,139,140,141,142,130,131,132,133,134,135,136,137,138,139,140,141,142,130,131,132,133,134,135,136,137,138,139,140,141,142,130,131,132,133,134,135,136,137,138,139,140,141,142,130,131,132,133,134,135,136,137,138,139,140,141,142,130,131,132,133,134,135,136,137,138,139,140,141,142,130,131,132,133,134,135,136,137,138
162,163,164,165,166,167,168,169,170,171,172,173,174,162,163,164,165,166,167,168,169,170,171,172,173,174,162,163,164,165,166,167,168,169,170,171,172,173,174,162,163,164,165,166,167,168,169,170,171,172,173,174,162,163,164,165,166,167,168,169,170,171,172,173,174,162,163,164,165,166,167,168,169,170,171,172,173,174,162,163,164,165,166,167,168,169,170,171,172,173,174,162,163,164,165,166,167,168,169,170
194,195,196,197,198,199,200,201,202,203,204,205,206,194,195,196,197,198,199,200,201,202,203,204,205,206,194,195,196,197,198,199,200,201,202,203,204,205,206,194,195,196,197,198,199,200,201,202,203,204,205,206,194,195,196,197,198,199,200,201,202,203,204,205,206,194,195,196,197,198,199,200,201,202,203,204,205,206,194,195,196,197,198,199,200,201,202,203,204,205,206,194,195,196,197,198,199,200,201,202
226,227,228,229,230,231,232,233,234,235,236,237,238,226,227,228,229,230,231,232,233,234,235,236,237,238,226,227,228,229,230,231,232,233,234,235,236,237,238,226,227,228,229,230,231,232,233,234,235,236,237,238,226,227,228,229,230,231,232,233,234,235,236,237,238,226,227,228,229,230,231,232,233,234,235,236,237,238,226,227,228,229,230,231,232,233,234,235,236,237,238,226,227,228,229,230,231,232,233,234
258,259,260,261,262,263,264,265,266,267,268,269,270,258,259,260,261,262,263,264,265,266,267,268,269,270,258,259,260,261,262,263,264,265,266,267,268,269,270,258,259,260,261,262,263,264,265,266,267,268,269,270,258,259,260,261,262,263,264,265,266,267,268,269,270,258,259,260,261,262,263,264,265,266,267,268,269,270,258,259,260,261,262,263,264,265,266,267,268,269,270,258,259,260,261,262,263,264,265,266
290,291,292,293,294,295,296,297,298,299,300,301,302,290,291,292,293,294,295,296,297,298,299,300,301,302,290,291,292,293,294,295,296,297,298,299,300,301,302,290,291,292,293,294,295,296,297,298,299,300,301,302,290,291,292,293,294,295,296,297,298,299,300,301,302,290,291,292,293,294,295,296,297,298,299,300,301,302,290,291,292,293,294,295,296,297,298,299,300,301,302,290,291,292,293,294,295,296,297,298
322,323,324,325,326,327,328,329,330,331,332,333,334,322,323,324,325,326,327,328,329,330,331,332,333,334,322,323,324,325,326,327,328,329,330,331,332,333,334,322,323,324,325,326,327,328,329,330,331,332,333,334,322,323,324,325,326,327,328,329,330,331,332,333,334,322,323,324,325,326,327,328,329,330,331,332,333,334,322,323,324,325,326,327,328,329,330,331,332,333,334,322,323,324,325,326,327,328,329,330
354,355,356,357,358,359,360,361,362,363,364,365,366,354,355,356,357,358,359,360,361,362,363,364,365,366,354,355,356,357,358,359,360,361,362,363,364,365,366,354,355,356,357,358,359,360,361,362,363,364,365,366,354,355,356,357,358,359,360,361,362,363,364,365,366,354,355,356,357,358,359,360,361,362,363,364,365,366,354,355,356,357,358,359,360,361,362,363,364,365,366,354,355,356,357,358,359,360,361,362
386,387,388,389,390,391,392,393,394,395,396,397,398,386,387,388,389,390,391,392,393,394,395,396,397,398,386,387,388,389,390,391,392,393,394,395,396,397,398,386,387,388,389,390,391,392,393,394,395,396,397,398,386,387,388,389,390,391,392,393,394,395,396,397,398,386,387,388,389,390,391,392,393,394,395,396,397,398,386,387,388,389,390,391,392,393,394,395,396,397,398,386,387,388,389,390,391,392,393,394
418,419,420,421,422,423,424,425,426,427,428,429,430,418,419,420,421,422,423,424,425,426,427,428,429,430,418,419,420,421,422,423,424,425,426,427,428,429,430,418,419,420,421,422,423,424,425,426,427,428,429,430,418,419,420,421,422,423,424,425,426,427,428,429,430,418,419,420,421,422,423,424,425,426,427,428,429,430,418,419,420,421,422,423,424,425,426,427,428,429,430,418,419,420,421,422,423,424,425,426
450,451,452,453,454,455,456,457,458,459,460,461,462,450,451,452,453,454,455,456,457,458,459,460,461,462,450,451,452,453,454,455,456,457,458,459,460,461,462,450,451,452,453,454,455,456,457,458,459,460,461,462,450,451,452,453,454,455,456,457,458,459,460,461,462,450,451,452,453,454,455,456,457,458,459,460,461,462,450,451,452,453,454,455,456,457,458,459,460,461,462,450,451,452,453,454,455,456,457,458
66,67,68,69,70,71,72,73,74,75,76,77,78,66,67,68,69,70,71,72,73,74,75,76,77,78,66,67,68,69,70,71,72,73,74,75,76,77,78,66,67,68,69,70,71,72,73,74,75,76,77,78,66,67,68,69,70,71,72,73,74,75,76,77,78,66,67,68,69,70,71,72,73,74,75,76,77,78,66,67,68,69,70,71,72,73,74,75,76,77,78,66,67,68,69,70,71,72,73,74
98,99,100,101,102,103,104,105,106,107,108,109,110,98,99,100,101,102,103,104,105,106,107,108,109,110,98,99,100,101,102,103,104,105,106,107,108,109,110,98,99,100,101,102,103,104,105,106,107,108,109,110,98,99,100,101,102,103,104,105,106,107,108,109,110,98,99,100,101,102,81,82,83,84,85,86,87,88,89,90,91,92,102,103,104,105,106,107,108,109,110,98,99,100,101,102,103,104,105,106
130,131,132,133,134,135,136,137,138,139,140,141,142,130,131,132,133,134,135,136,137,138,139,140,141,142,130,131,132,133,134,135,136,137,138,139,140,141,142,130,131,132,133,134,135,136,137,138,139,140,141,142,130,131,132,133,134,135,136,137,138,139,140,141,142,130,131,132,133,134,113,114,115,116,117,118,119,120,121,122,123,124,134,135,136,137,138,139,140,141,142,130,131,132,133,134,135,136,137,138
162,163,164,165,166,167,168,169,170,171,172,173,174,162,163,164,165,166,167,168,169,170,171,172,173,174,162,163,164,165,166,167,168,169,170,171,172,173,174,162,163,164,165,166,167,168,169,170,171,172,173,174,162,163,164,165,166,167,168,169,170,171,172,173,174,162,163,164,165,166,145,146,147,148,149,150,151,152,153,154,155,156,166,167,168,169,170,171,172,173,174,162,163,164,165,166,167,168,169,170
194,195,196,197,198,199,200,201,202,203,204,205,206,194,195,196,197,198,199,200,201,202,203,204,205,206,194,195,196,197,198,199,200,201,202,203,204,205,206,194,195,196,197,198,199,200,201,202,203,204,205,206,194,195,196,197,198,199,200,201,202,203,204,205,206,194,195,196,197,198,177,178,179,180,181,182,183,184,185,186,187,188,198,199,200,201,202,203,204,205,206,194,195,196,197,198,199,200,201,202
226,227,228,229,230,231,232,233,234,235,236,237,238,226,227,228,229,230,231,232,233,234,235,236,237,238,226,227,228,229,230,231,232,233,234,235,236,237,238,226,227,228,229,230,231,232,233,234,235,236,237,238,226,227,228,229,230,231,232,233,234,235,236,237,238,226,227,228,229,230,209,210,211,212,213,214,215,216,217,218,219,220,230,231,232,233,234,235,236,237,238,226,227,228,229,230,231,232,233,234
258,259,260,261,262,263,264,265,266,267,268,269,270,258,259,260,261,262,263,264,265,266,267,268,269,270,258,259,260,261,262,263,264,265,266,267,268,269,270,258,259,260,261,262,263,264,265,266,267,268,269,270,258,259,260,261,262,263,264,265,266,267,268,269,270,258,259,260,261,262,241,242,243,244,245,246,247,248,249,250,251,252,262,263,264,265,266,267,268,269,270,258,259,260,261,262,263,264,265,266
776,777,778,779,780,781,782,783,784,785,786,787,788,789,790,791,293,294,295,296,297,298,299,300,301,302,290,291,292,293,294,295,296,297,298,299,300,301,302,81,82,83,84,85,86,87,88,89,90,91,92,93,81,82,83,84,85,86,87,88,89,90,91,301,302,290,291,292,293,294,273,274,275,276,277,278,279,280,281,282,283,284,294,295,296,297,298,299,300,301,302,290,291,292,293,294,295,296,297,298
808,809,810,811,812,813,814,815,816,817,818,819,820,821,822,823,325,326,327,328,329,330,331,332,333,334,322,323,324,325,326,327,328,329,330,331,332,333,334,113,114,115,116,117,118,119,120,121,122,123,124,125,113,114,115,116,117,118,119,120,121,122,123,333,334,322,323,324,325,326,305,306,307,308,309,310,311,312,313,314,315,316,326,327,328,329,330,331,332,333,334,322,323,324,325,326,327,328,329,330
840,841,842,843,844,845,846,847,848,849,850,851,852,853,854,855,357,358,359,360,361,362,363,364,365,366,354,355,356,357,358,359,360,361,362,363,364,365,366,145,146,147,148,149,150,151,152,153,154,155,156,157,354,355,356,357,358,359,360,361,362,363,364,365,366,354,355,356,357,358,337,338,339,340,341,342,343,344,345,346,347,348,358,359,360,361,362,363,364,365,366,354,355,356,357,358,359,360,361,362
872,873,874,875,876,877,878,879,880,881,882,883,884,885,886,887,389,390,391,392,393,394,395,396,397,398,386,387,388,389,390,391,392,393,394,395,396,397,398,177,178,179,180,181,182,183,184,185,186,187,188,189,386,387,388,389,390,391,392,393,394,395,396,397,398,386,387,388,389,390,369,370,371,372,373,374,375,376,377,378,379,380,390,391,392,393,394,395,396,397,398,386,387,388,389,390,391,392,393,394
904,905,906,907,908,909,910,911,912,913,914,915,916,917,918,919,421,422,423,424,425,426,427,428,429,430,418,419,420,421,422,423,424,425,426,427,428,429,430,209,210,211,212,213,214,215,216,217,218,219,220,221,418,419,420,421,422,423,424,425,426,427,428,429,430,418,419,420,421,422,401,402,403,404,405,406,407,408,409,410,411,412,422,423,424,425,426,427,428,429,430,418,419,420,421,422,423,424,425,426
936,937,938,939,940,941,942,943,944,945,946,947,948,949,950,951,453,454,455,456,457,458,459,460,461,462,450,451,452,453,454,455,456,457,458,459,460,461,462,241,242,243,244,245,246,247,248,249,250,251,252,253,450,451,452,453,454,455,456,457,458,459,460,461,462,450,451,452,453,454,433,434,435,436,437,438,439,440,441,442,443,444,454,455,456,457,458,459,460,461,462,450,451,452,453,454,455,456,457,458
81,82,83,84,85,86,87,88,89,90,91,92,93,81,82,83,84,85,86,87,88,89,90,91,92,93,81,82,83,84,85,86,87,88,89,90,91,92,93,273,274,275,276,277,278,279,280,281,282,283,284,285,66,67,68,69,70,71,72,73,74,75,76,77,78,66,67,68,69,70,81,82,83,84,85,86,87,88,89,90,91,92,70,71,72,73,74,75,76,77,78,66,67,68,69,70,71,72,73,74
113,114,115,116,117,118,119,120,121,122,123,124,125,113,114,115,116,117,118,119,120,121,122,123,124,125,113,114,115,116,117,118,119,120,121,122,123,124,125,305,306,307,308,309,310,311,312,313,314,315,316,317,98,99,100,101,102,103,104,105,106,107,108,109,110,98,99,100,101,102,113,114,115,116,117,118,119,120,121,122,123,124,102,103,104,105,106,107,108,109,110,98,99,100,101,102,103,104,105,106
145,146,147,148,149,150,151,152,153,154,155,156,157,145,146,147,148,149,150,151,152,153,154,155,156,157,145,146,147,148,149,150,151,152,153,154,155,156,157,337,338,339,340,341,342,343,344,345,346,347,348,349,130,131,132,133,134,135,136,137,138,139,140,141,142,130,131,132,133,134,145,146,147,148,149,150,151,152,153,154,155,156,134,135,136,137,138,139,140,141,142,130,131,132,133,134,135,136,137,138
177,178,179,180,181,182,183,184,185,186,187,188,189,177,178,179,180,181,182,183,184,185,186,187,188,189,177,178,179,180,181,182,183,184,185,186,187,188,189,369,370,371,372,373,374,375,376,377,378,379,380,381,162,163,164,165,166,167,168,169,170,171,172,173,174,162,163,164,165,166,177,178,179,180,181,182,183,184,185,186,187,188,166,167,168,169,170,171,172,173,174,162,163,164,165,166,167,168,169,170
209,210,211,212,213,214,215,216,217,218,219,220,221,209,210,211,212,213,214,215,216,217,218,219,220,221,209,210,211,212,213,214,215,216,217,218,219,220,221,401,402,403,404,405,406,407,408,409,410,411,412,413,194,195,196,197,198,199,200,201,202,203,204,205,206,194,195,196,197,198,209,210,211,212,213,214,215,216,217,218,219,220,198,199,200,201,202,203,204,205,206,194,195,196,197,198,199,200,201,202
241,242,243,244,245,246,247,248,249,250,251,252,253,241,242,243,244,245,246,247,248,249,250,251,252,253,241,242,243,244,245,246,247,248,249,250,251,252,253,433,434,435,436,437,438,439,440,441,442,443,444,445,226,227,228,229,230,231,232,233,234,235,236,237,238,226,227,228,229,230,241,242,243,244,245,246,247,248,249,250,251,252,230,231,232,233,234,235,236,237,238,226,227,228,229,230,231,232,233,234
273,274,275,276,277,278,279,280,281,282,283,284,285,273,274,275,276,277,278,279,280,281,282,283,284,285,273,274,275,276,277,278,279,280,281,282,283,284,285,465,466,467,468,469,470,471,472,473,474,475,476,477,258,259,260,261,262,263,264,265,266,267,268,269,270,258,259,260,261,262,273,274,275,276,277,278,279,280,281,282,283,284,262,263,264,265,266,267,268,269,270,258,259,260,261,262,263,264,265,266
305,306,307,308,309,310,311,312,313,314,315,316,317,305,306,307,308,309,310,311,312,313,314,315,316,317,305,306,307,308,309,310,311,312,313,314,315,316,317,290,291,292,293,294,295,296,297,298,299,300,301,302,290,291,292,293,294,295,296,297,298,299,300,301,302,290,291,292,293,294,305,306,307,308,309,310,311,312,313,314,315,316,294,295,296,297,298,299,300,301,302,290,291,292,293,294,295,296,297,298
337,338,339,340,341,342,343,344,345,346,347,348,349,337,338,339,340,341,342,343,344,345,346,347,348,349,337,338,339,340,341,342,343,344,345,346,347,348,349,322,323,324,325,326,327,328,329,330,331,332,333,334,322,323,324,325,326,327,328,329,330,331,332,333,334,322,323,324,325,326,337,338,339,340,341,342,343,344,345,346,347,348,326,327,328,329,330,331,332,333,334,322,323,324,325,326,327,328,329,330
369,370,371,372,373,374,375,376,377,378,379,380,381,369,370,371,372,373,374,375,376,377,378,379,380,381,369,370,371,372,373,374,375,376,377,378,379,380,381,354,355,356,357,358,359,360,361,362,363,364,365,366,354,355,356,357,358,359,360,361,362,363,364,365,366,354,355,356,357,358,369,370,371,372,373,374,375,376,377,378,379,380,358,359,360,361,362,363,364,365,366,354,355,356,357,358,359,360,361,362
401,402,403,404,405,406,407,408,409,410,411,412,413,401,402,403,404,405,406,407,408,409,410,411,412,413,401,402,403,404,405,406,407,408,409,410,411,412,413,386,387,388,389,390,391,392,393,394,395,396,397,398,386,387,388,389,390,391,392,393,394,395,396,397,398,386,387,388,389,390,401,402,403,404,405,406,407,408,409,410,411,412,390,391,392,393,394,395,396,397,398,386,387,388,389,390,391,392,393,394
433,434,435,436,437,438,439,440,441,442,443,444,445,433,434,435,436,437,438,439,440,441,442,443,444,445,433,434,435,436,437,438,439,440,441,442,443,444,445,418,419,420,421,422,423,424,425,426,427,428,429,430,418,419,420,421,422,423,424,425,426,427,428,429,430,418,419,420,421,422,433,434,435,436,437,438,439,440,441,442,443,444,422,423,424,425,426,427,428,429,430,418,419,420,421,422,423,424,425,426
465,466,467,468,469,470,471,472,473,474,475,476,477,465,466,467,468,469,470,471,472,473,474,475,476,477,465,466,467,468,469,470,471,472,473,474,475,476,477,450,451,452,453,454,455,456,457,458,459,460,461,462,450,451,452,453,454,455,456,457,458,459,460,461,462,450,451,452,453,454,81,82,83,84,85,86,87,88,89,90,91,92,454,455,456,457,458,459,460,461,462,450,451,452,453,454,455,456,457,458
66,67,68,69,70,71,72,73,74,75,76,77,78,66,67,68,69,70,71,72,73,74,75,76,77,78,66,67,68,69,70,71,72,73,74,75,76,77,78,66,67,68,69,70,71,72,73,74,75,76,77,78,66,67,68,69,70,71,72,73,74,75,76,77,78,66,67,68,69,70,113,114,115,116,117,118,119,120,121,122,123,124,70,71,72,73,74,75,76,77,78,66,67,68,69,70,71,72,73,74
98,99,100,101,102,103,104,105,106,107,108,109,110,98,99,100,101,102,103,104,105,106,107,108,109,110,98,99,100,101,102,103,104,105,106,107,108,109,110,98,99,100,101,102,103,104,105,106,107,108,109,110,98,99,100,101,102,103,104,105,106,107,108,109,110,98,99,100,101,102,145,146,147,148,149,150,151,152,153,154,155,156,102,103,104,105,106,107,108,109,110,98,99,100,101,102,103,104,105,106
130,131,132,133,134,135,136,137,138,139,140,141,142,130,131,132,133,134,135,136,137,138,139,140,141,142,130,131,132,133,134,135,136,137,138,139,140,141,142,130,131,132,133,134,135,136,137,138,139,140,141,142,130,131,132,133,134,135,136,137,138,139,140,141,142,130,131,132,133,134,177,178,179,180,181,182,183,184,185,186,187,188,134,135,136,137,138,139,140,141,142,130,131,132,133,134,135,136,137,138
162,163,164,165,166,167,168,169,170,171,172,173,174,162,163,164,165,166,167,168,169,170,171,172,173,174,162,163,164,165,166,167,168,169,170,171,172,173,174,162,163,164,165,166,167,168,169,170,171,172,173,174,162,163,164,165,166,167,168,169,170,171,172,173,174,162,163,164,165,166,209,210,211,212,213,214,215,216,217,218,219,220,166,167,168,169,170,171,172,173,174,162,163,164,165,166,167,168,169,170
194,195,196,197,198,199,200,201,202,203,204,205,206,194,195,196,197,198,199,200,201,202,203,204,205,206,194,195,196,197,198,199,200,201,202,203,204,205,206,194,195,196,197,198,199,200,201,202,203,204,205,206,194,195,196,197,198,199,200,201,202,203,204,205,206,194,195,196,197,198,241,242,243,244,245,246,247,248,249,250,251,252,198,199,200,201,202,203,204,205,206,194,195,196,197,198,199,200,201,202
226,227,228,229,230,231,232,233,234,235,236,237,238,226,227,228,229,230,231,232,233,234,235,236,237,238,226,227,228,229,230,231,232,233,234,235,236,237,776,777,778,779,780,781,782,783,784,785,786,787,788,789,790,791,776,777,778,779,780,781,782,783,784,785,786,787,788,789,790,791,273,274,275,276,277,278,279,280,281,282,283,284,230,231,232,233,234,235,236,237,238,226,227,228,229,230,231,232,233,234
258,259,260,261,262,263,264,265,266,267,268,269,270,258,259,260,261,262,263,264,265,266,267,268,269,270,258,259,260,261,262,263,264,265,266,267,268,269,808,809,810,811,812,813,814,815,816,817,818,819,820,821,822,823,808,809,810,811,812,813,814,815,816,817,818,819,820,821,822,823,305,306,307,308,309,310,311,312,313,314,315,316,262,263,264,265,266,267,268,269,270,258,259,260,261,262,263,264,265,266
290,291,292,293,294,295,296,297,298,299,300,301,302,290,291,292,293,294,295,296,297,298,299,300,301,302,290,291,292,293,294,295,296,297,298,299,300,301,840,841,842,843,844,845,846,847,848,849,850,851,852,853,854,855,840,841,842,843,844,845,846,847,848,849,850,851,852,853,854,855,337,338,339,340,341,342,343,344,345,346,347,348,294,295,296,297,298,299,300,301,302,290,291,292,293,294,295,296,297,298
322,323,324,325,326,327,328,329,330,331,332,333,334,322,323,324,325,326,327,328,329,330,331,332,333,334,322,323,324,325,326,327,328,329,330,331,332,333,872,873,874,875,876,877,878,879,880,881,882,883,884,885,886,887,872,873,874,875,876,877,878,879,880,881,882,883,884,885,886,887,369,370,371,372,373,374,375,376,377,378,379,380,326,327,328,329,330,331,332,333,334,322,323,324,325,326,327,328,329,330
354,355,356,357,358,359,360,361,362,363,364,365,366,354,355,356,357,358,359,360,361,362,363,364,365,366,354,355,356,357,358,359,360,361,362,363,364,365,904,905,906,907,908,909,910,911,912,913,914,915,916,917,918,919,904,905,906,907,908,909,910,911,912,913,914,915,916,917,918,919,401,402,403,404,405,406,407,408,409,410,411,412,358,359,360,361,362,363,364,365,366,354,355,356,357,358,359,360,361,362
386,387,388,389,390,391,392,393,394,395,396,397,398,386,387,388,389,390,391,392,393,394,395,396,397,398,386,387,388,389,390,391,392,393,394,395,396,397,936,937,938,939,940,941,942,943,944,945,946,947,948,949,950,951,936,937,938,939,940,941,942,943,944,945,946,947,948,949,950,951,433,434,435,436,437,438,439,440,441,442,443,444,390,391,392,393,394,395,396,397,398,386,387,388,389,390,391,392,393,394
